WWWWWWWWW
W       W
W       W
W       W 
W       W
W       W
W       W
W       W
W       W 
W       W
W       W
W       W
W       W
W       W 
W       W
W       W
W       W
W       W
W       W 
W       W
W       W
W       W
W       W
W       W 
W       W
W       W
W       W
W       W
W       W
W       W 
W       W
W       W
W       W
W       W
W       W 
W       W
W       W
W       W
W       W
W       W 
W       W
W       W
W       W
W       W
W       W 
W       W
W       W
W       W
W       W
W VVSVV W
WWWWWWWWW